|-----------------------------------------------------------------------------|
|                                                                             |
|                                                                             |
|    |---------------|         |---------------|                              |
|    |...............|         |...............|                              |
|    |...............|         |...............|                              |
|    |...............|         |...............|                              |
|    |...............|         |...............|                              |
|    |...............|         |...............|                              |
|    |...............+#########+...............|                              |
|    |...............|         |...............|                              |
|    |...............|         |...............|                              |
|    |...............|         |...............|                              |
|    |---------------|         |---------------|                              |
|                                                                             |
|                                                                             |
|                                                                             |
|                                                                             |
|                                                                             |
|                                                                             |
|                                                                             |
|                                                                             |
|                                                                             |
|                                                                             |
|-----------------------------------------------------------------------------|
|-----------------------------------------------------------------------------|
|                                                                             |
|                                                                             |
|    |---------------|         |---------------|                              |
|    |...............|         |...............|                              |
|    |...............|         |...............|                              |
|    |...............|         |...............|                              |
|    |...............|         |...............|                              |
|    |...............|         |...............|                              |
|    |...............+#########+...............|                              |
|    |...............|         |...............|                              |
|    |...............|         |...............|                              |
|    |...............|         |...............|                              |
|    |---------------|         |---------------|                              |
|                                                                             |
|                                                                             |
|                                                                             |
|                                                                             |
|                                                                             |
|                                                                             |
|                                                                             |
|                                                                             |
|                                                                             |
|                                                                             |
|-----------------------------------------------------------------------------|
|-----------------------------------------------------------------------------|
|                                                                             |
|                                                                             |
|    |---------------|         |---------------|                              |
|    |...............|         |...............|                              |
|    |...............|         |...............|                              |
|    |...............|         |...............|                              |
|    |...............|         |...............|                              |
|    |...............|         |...............|                              |
|    |...............+#########+...............|                              |
|    |...............|         |...............|                              |
|    |...............|         |...............|                              |
|    |...............|         |...............|                              |
|    |---------------|         |---------------|                              |
|                                                                             |
|                                                                             |
|                                                                             |
|                                                                             |
|                                                                             |
|                                                                             |
|                                                                             |
|                                                                             |
|                                                                             |
|                                                                             |
|-----------------------------------------------------------------------------|
|-----------------------------------------------------------------------------|
|                                                                             |
|                                                                             |
|    |---------------|         |---------------|                              |
|    |...............|         |...............|                              |
|    |...............|         |...............|                              |
|    |...............|         |...............|                              |
|    |...............|         |...............|                              |
|    |...............|         |...............|                              |
|    |...............+#########+...............|                              |
|    |...............|         |...............|                              |
|    |...............|         |...............|                              |
|    |...............|         |...............|                              |
|    |---------------|         |---------------|                              |
|                                                                             |
|                                                                             |
|                                                                             |
|                                                                             |
|                                                                             |
|                                                                             |
|                                                                             |
|                                                                             |
|                                                                             |
|                                                                             |
|-----------------------------------------------------------------------------|
|-----------------------------------------------------------------------------|
|                                                                             |
|                                                                             |
|    |---------------|         |---------------|                              |
|    |...............|         |...............|                              |
|    |...............|         |...............|                              |
|    |...............|         |...............|                              |
|    |...............|         |...............|                              |
|    |...............|         |...............|                              |
|    |...............+#########+...............|                              |
|    |...............|         |...............|                              |
|    |...............|         |...............|                              |
|    |...............|         |...............|                              |
|    |---------------|         |---------------|                              |
|                                                                             |
|                                                                             |
|                                                                             |
|                                                                             |
|                                                                             |
|                                                                             |
|                                                                             |
|                                                                             |
|                                                                             |
|                                                                             |
|-----------------------------------------------------------------------------|
